NO ./textures/floar_img.xpm
SO ./textures/wall_img.xpm
WE ./textures/wall_img.xpm
EA ./textures/floar_img.xpm
C 10, 89, 145
F 209, 95, 43

        1111111111111111111111111
        100000000011B00000D00001
        10110000011100000000X0001
        10010E00000000B0X0000D001
111111110011000001110000000000001
100000000011000001110111111111111
11110111111111011100000010001
11110111111111011101010010001
11000000110101011100000010001
1000000000000000000000X000001
1000X000000000001101010010001
110000B111010101111101111000111
11110111 1110101 101111010001
11111111 1111111 111111111111