NO ./path_to_the_north_texture
SO ./path_to_the_south_texture
WE ./path_to_the_west_texture
EA ./path_to_the_east_texture
C 220,20,235
F 84,84,84

        1111111111111111111111111
        1000000000110000000000001
        1011000001110000000000001
        1001000000000000000000001
111111110110000011100000000000001
100000000011000001110111111111111
11110111111111011111111000000000111111111111111
111101111111110111    1010100000000000000000001
11000000110101011111111000000000000000000111111
100000000000000011000000000000000000000001
100000000000000011010100000000111111111111
1100000111010101111101110N0111
11110111 1110101 101111010001
11111111 1111111 111111111111