NO ./textures/block.xpm
SO ./textures/block.xpm
WE ./textures/block.xpm
EA ./textures/block.xpm
C 220,220,235
F 84,84,84

        1111111111111111111111111
        1000000000110000000000001
        1011000001110000000000001
        1001000000000000000000001
111111110110000011100000000000001
100000000011000001110111111111111
11110111111111011111111000000000111111111111111
111101111111110111    1010100000000000000000001
11000000110101011111111000000000000000000111111
1000N0000000000011000000000000000000000001
100000000000000011010100000000111111111111
110000011101010111110111000111
11110111 1110101 1011110000001
11111111 1111111 111111111111